|/.'                                                                  \
--------------                                                        \
|'.             .                     X                    .          \
|\ '.                       .                        . .              \
| \                                                                   \
|  \      x                                                           \
|   \       X               88888888888.                              \
     \              888888888888888888888888888      X                \
                88888888888888888888888888888888888                   \
             88888888888888888888888888888888888888888                \
